Empty
MaxSteps = 10
NumShells = 1
Rows = 12
Cols = 12

1221.......2
....1......2
....1......2
....1......2
............
............
............
............
............
............
............
............